"filename", "language", "JavaScript", "CSS", "JSON", "vue", "comment", "blank", "total"
"c:\Users\pmpls\Desktop\codebase\ViralPlan\viralplan-creators\frontend\src\App.vue", "vue", 0, 0, 0, 375, 0, 24, 399
"c:\Users\pmpls\Desktop\codebase\ViralPlan\viralplan-creators\frontend\src\assets\base.css", "CSS", 0, 26, 0, 0, 0, 1, 27
"c:\Users\pmpls\Desktop\codebase\ViralPlan\viralplan-creators\frontend\src\assets\main.css", "CSS", 0, 28, 0, 0, 0, 7, 35
"c:\Users\pmpls\Desktop\codebase\ViralPlan\viralplan-creators\frontend\src\assets\taskList.js", "JavaScript", 564, 0, 0, 0, 5, 108, 677
"c:\Users\pmpls\Desktop\codebase\ViralPlan\viralplan-creators\frontend\src\components\App\AudioRecorder.vue", "vue", 0, 0, 0, 102, 0, 8, 110
"c:\Users\pmpls\Desktop\codebase\ViralPlan\viralplan-creators\frontend\src\components\App\PopupModal.vue", "vue", 0, 0, 0, 739, 18, 17, 774
"c:\Users\pmpls\Desktop\codebase\ViralPlan\viralplan-creators\frontend\src\components\App\PopupModalCompletedTask.vue", "vue", 0, 0, 0, 100, 0, 11, 111
"c:\Users\pmpls\Desktop\codebase\ViralPlan\viralplan-creators\frontend\src\components\App\PopupModalForm.vue", "vue", 0, 0, 0, 135, 0, 14, 149
"c:\Users\pmpls\Desktop\codebase\ViralPlan\viralplan-creators\frontend\src\components\App\Sidebar.vue", "vue", 0, 0, 0, 51, 0, 5, 56
"c:\Users\pmpls\Desktop\codebase\ViralPlan\viralplan-creators\frontend\src\components\VideoView.vue", "vue", 0, 0, 0, 270, 1, 14, 285
"c:\Users\pmpls\Desktop\codebase\ViralPlan\viralplan-creators\frontend\src\components\VideoViewForClients.vue", "vue", 0, 0, 0, 138, 1, 4, 143
"c:\Users\pmpls\Desktop\codebase\ViralPlan\viralplan-creators\frontend\src\main.js", "JavaScript", 26, 0, 0, 0, 0, 5, 31
"c:\Users\pmpls\Desktop\codebase\ViralPlan\viralplan-creators\frontend\src\router\index.js", "JavaScript", 77, 0, 0, 0, 0, 3, 80
"c:\Users\pmpls\Desktop\codebase\ViralPlan\viralplan-creators\frontend\src\stores\companies.js", "JavaScript", 8, 0, 0, 0, 0, 2, 10
"c:\Users\pmpls\Desktop\codebase\ViralPlan\viralplan-creators\frontend\src\stores\company.js", "JavaScript", 42, 0, 0, 0, 0, 2, 44
"c:\Users\pmpls\Desktop\codebase\ViralPlan\viralplan-creators\frontend\src\stores\forms.js", "JavaScript", 8, 0, 0, 0, 0, 1, 9
"c:\Users\pmpls\Desktop\codebase\ViralPlan\viralplan-creators\frontend\src\stores\user.js", "JavaScript", 13, 0, 0, 0, 0, 2, 15
"c:\Users\pmpls\Desktop\codebase\ViralPlan\viralplan-creators\frontend\src\stores\users.js", "JavaScript", 8, 0, 0, 0, 0, 2, 10
"c:\Users\pmpls\Desktop\codebase\ViralPlan\viralplan-creators\frontend\src\utils\dates.js", "JavaScript", 63, 0, 0, 0, 5, 20, 88
"c:\Users\pmpls\Desktop\codebase\ViralPlan\viralplan-creators\frontend\src\utils\db\companyModel.js", "JavaScript", 106, 0, 0, 0, 0, 7, 113
"c:\Users\pmpls\Desktop\codebase\ViralPlan\viralplan-creators\frontend\src\utils\db\formsModel.js", "JavaScript", 62, 0, 0, 0, 0, 3, 65
"c:\Users\pmpls\Desktop\codebase\ViralPlan\viralplan-creators\frontend\src\utils\db\misc.js", "JavaScript", 235, 0, 0, 0, 1, 19, 255
"c:\Users\pmpls\Desktop\codebase\ViralPlan\viralplan-creators\frontend\src\utils\db\planModel.js", "JavaScript", 3, 0, 0, 0, 0, 2, 5
"c:\Users\pmpls\Desktop\codebase\ViralPlan\viralplan-creators\frontend\src\utils\db\userModel.js", "JavaScript", 109, 0, 0, 0, 0, 7, 116
"c:\Users\pmpls\Desktop\codebase\ViralPlan\viralplan-creators\frontend\src\utils\ideas.json", "JSON", 0, 0, 22, 0, 0, 1, 23
"c:\Users\pmpls\Desktop\codebase\ViralPlan\viralplan-creators\frontend\src\utils\plans\font.js", "JavaScript", 2, 0, 0, 0, 0, 1, 3
"c:\Users\pmpls\Desktop\codebase\ViralPlan\viralplan-creators\frontend\src\utils\plans\ideaGeneration.js", "JavaScript", 122, 0, 0, 0, 0, 14, 136
"c:\Users\pmpls\Desktop\codebase\ViralPlan\viralplan-creators\frontend\src\utils\plans\plan_20.js", "JavaScript", 1, 0, 0, 0, 0, 0, 1
"c:\Users\pmpls\Desktop\codebase\ViralPlan\viralplan-creators\frontend\src\utils\plans\plan_5.js", "JavaScript", 2, 0, 0, 0, 0, 1, 3
"c:\Users\pmpls\Desktop\codebase\ViralPlan\viralplan-creators\frontend\src\utils\plans\processInput.js", "JavaScript", 97, 0, 0, 0, 2, 8, 107
"c:\Users\pmpls\Desktop\codebase\ViralPlan\viralplan-creators\frontend\src\utils\plans\promptGPT.js", "JavaScript", 177, 0, 0, 0, 25, 10, 212
"c:\Users\pmpls\Desktop\codebase\ViralPlan\viralplan-creators\frontend\src\views\Companies\CompaniesCreatorView.vue", "vue", 0, 0, 0, 172, 0, 10, 182
"c:\Users\pmpls\Desktop\codebase\ViralPlan\viralplan-creators\frontend\src\views\Companies\CompaniesEditorView.vue", "vue", 0, 0, 0, 123, 0, 9, 132
"c:\Users\pmpls\Desktop\codebase\ViralPlan\viralplan-creators\frontend\src\views\Companies\CompaniesEraserView.vue", "vue", 0, 0, 0, 31, 0, 3, 34
"c:\Users\pmpls\Desktop\codebase\ViralPlan\viralplan-creators\frontend\src\views\Companies\CompaniesView.vue", "vue", 0, 0, 0, 53, 0, 5, 58
"c:\Users\pmpls\Desktop\codebase\ViralPlan\viralplan-creators\frontend\src\views\HomeView.vue", "vue", 0, 0, 0, 292, 0, 13, 305
"c:\Users\pmpls\Desktop\codebase\ViralPlan\viralplan-creators\frontend\src\views\Plans\PlansClientView.vue", "vue", 0, 0, 0, 62, 0, 5, 67
"c:\Users\pmpls\Desktop\codebase\ViralPlan\viralplan-creators\frontend\src\views\Plans\PlansCreatorView.vue", "vue", 0, 0, 0, 346, 0, 15, 361
"c:\Users\pmpls\Desktop\codebase\ViralPlan\viralplan-creators\frontend\src\views\Plans\PlansEditorView.vue", "vue", 0, 0, 0, 122, 0, 5, 127
"c:\Users\pmpls\Desktop\codebase\ViralPlan\viralplan-creators\frontend\src\views\Plans\PlansEraserView.vue", "vue", 0, 0, 0, 45, 0, 3, 48
"c:\Users\pmpls\Desktop\codebase\ViralPlan\viralplan-creators\frontend\src\views\Plans\PlansView.vue", "vue", 0, 0, 0, 83, 0, 7, 90
"Total", "-", 1725, 54, 22, 3239, 58, 398, 5496